[console_scripts]
rebase-helper = rebasehelper.cli:CliHelper.run

[rebasehelper.build_log_hooks]
files = rebasehelper.plugins.build_log_hooks.files:Files

[rebasehelper.build_tools]
copr = rebasehelper.plugins.build_tools.rpm.copr_:Copr
koji = rebasehelper.plugins.build_tools.rpm.koji_:Koji
mock = rebasehelper.plugins.build_tools.rpm.mock:Mock
rpmbuild = rebasehelper.plugins.build_tools.rpm.rpmbuild:Rpmbuild

[rebasehelper.checkers]
abipkgdiff = rebasehelper.plugins.checkers.abipkgdiff:AbiPkgDiff
csmock = rebasehelper.plugins.checkers.csmock:CsMock
licensecheck = rebasehelper.plugins.checkers.licensecheck:LicenseCheck
pkgdiff = rebasehelper.plugins.checkers.pkgdiff:PkgDiff
rpmdiff = rebasehelper.plugins.checkers.rpmdiff:RpmDiff
rpminspect-rpm = rebasehelper.plugins.checkers.rpminspect_rpm:RpminspectRpm
rpminspect-srpm = rebasehelper.plugins.checkers.rpminspect_srpm:RpminspectSrpm
sonamecheck = rebasehelper.plugins.checkers.sonamecheck:SonameCheck

[rebasehelper.output_tools]
json = rebasehelper.plugins.output_tools.json_:JSON
text = rebasehelper.plugins.output_tools.text:Text

[rebasehelper.spec_hooks]
commit-hash-updater = rebasehelper.plugins.spec_hooks.commit_hash_updater:CommitHashUpdater
escape-macros = rebasehelper.plugins.spec_hooks.escape_macros:EscapeMacros
paths-to-rpm-macros = rebasehelper.plugins.spec_hooks.paths_to_rpm_macros:PathsToRPMMacros
pypi-url-fix = rebasehelper.plugins.spec_hooks.pypi_url_fix:PyPIURLFix
replace-old-version = rebasehelper.plugins.spec_hooks.replace_old_version:ReplaceOldVersion
ruby-helper = rebasehelper.plugins.spec_hooks.ruby_helper:RubyHelper
typo-fix = rebasehelper.plugins.spec_hooks.typo_fix:TypoFix

[rebasehelper.srpm_build_tools]
mock = rebasehelper.plugins.build_tools.srpm.mock:Mock
rpmbuild = rebasehelper.plugins.build_tools.srpm.rpmbuild:Rpmbuild

[rebasehelper.versioneers]
anitya = rebasehelper.plugins.versioneers.anitya:Anitya
cpan = rebasehelper.plugins.versioneers.cpan:CPAN
hackage = rebasehelper.plugins.versioneers.hackage:Hackage
npmjs = rebasehelper.plugins.versioneers.npmjs:NPMJS
pypi = rebasehelper.plugins.versioneers.pypi:PyPI
rubygems = rebasehelper.plugins.versioneers.rubygems:RubyGems

